



NO        ./path_to_the_north_texture

SO ./path_to_the_south_texture

WE       ./path_to_the_west_texture

C 225,30,0
EA      ./path_to_the_east_textur


F 220,250,00



111111   1          		    1
    1011101
1111100011011111111111111
1000000000110000000000001       1
1011000001110000000000001      101
100100000000000000000001111111111
111111111011000001110000000000001
100000000010000001110111111111111
11110011110001111111111111111111
11110011110001111111111111111111
11110111111111011100000010001
11110111111111011101010010001
11000000110101011100000010001
10000000000000001100000010001
10000S0000000001101010010001
110000011101010111110111100111
11110111 1110101 101111001001
11111111 1111111 111111111111
