



NO        ./path_to_the_north_texture

SO ./path_to_the_south_texture

WE       ./path_to_the_west_texture

C 225,30,0
EA      ./path_to_the_east_textur


F 220,250,00



111Q11   1          		    1
    1011101Q
1111100011011111111111111Q
100000000011000Q000000001       1
1011000001110000000000001      101
100100000000000000000001111111111Q
111111111011000001110000000000001Q
10000000011000001110111111111111Q
1111111111111111111111111111111Q
111111111111111111111111111111111Q
11110111111111011100000010001Q
1111011111111101110110010001Q
11000000110101011100000010001Q
10000000000000001100000010001
100000000S000001101010100011
110000011101010111110111100111
11110111 1110101 101111001001
11111111 11Q1111 111111111111
