NO ./path_to_the_north_texture

SO ./path_to_the_south_texture

WE ./path_to_the_west_texture

EA ./path_to_the_east_textur

F 220,250,0

C 225,30,0


11111111111
1011111    
10W00001   
1111111    