NO ./path_to_the_north_texture

SO ./path_to_the_south_texture

WE ./path_to_the_west_texture

EA ./path_to_the_east_textur

F 220,250,0

C 225,30,0

        1111111111111
        1000000000111
        1011000001111
        1001000000001
111111111011000001111
100000000011000001111
111101001111110100001
111101000000110001011
1100W0001101110001001
110000001101010001001
110000001101010001001
111111111111111111111