NO ./textures/wall1.png

SO ./textures/wall2.png

WE ./textures/wall3.png

EA ./textures/wall4.png

F 99,101,44

C 77,23,255

        1111111111111111111111111
        1000000000110000000000001
        1001000001110000000000001
        1000000000000000000000001
111111111001000001110000000000001
100000000011000001110111111111111
1111011111  11111   11 111
111101111111111111111111111111
111100000000000011100000010001
1111011111D111011101010010001
11000000110101011100000000001
1000000000W000000000000010001
10000000000000001101010010001
110000011101010111110111100111
11110111 1110101 10111101000101
11111111 1111111 1111111111111
