NO ./path_to_the_north_texture

SO ./path_to_the_south_texture

WE ./path_to_the_west_texture

EA ./path_to_the_east_textur

F 220,250,0

C 225,30,0

        1111111111111111111111111
        1000000000110000000000001
        1011000001110000000000001
        1001000000000000000000001
111111111011000001110000000000001
100000000011000001110111111111111
11110111111111011100000010001111
1111011111111101110101001000111
1100000011010101110000001000111
1000000000000000110000W00000111
1000010001000001101010000001111
100010000010000110101000000111
1000000000000000110101000000111
1000000000000000110101000000111
1110000111010101111101111001111
11110111 1110101 10111101000111
11111111 1111111 1111111111111