NO ./path_to_the_north_texture

SO ./path_to_the_south_texture

WE ./path_to_the_west_texture

EA ./path_to_the_east_textur

F 220,250,0

C 225,30,0

        1111111111111111111111111
        1000000000110000000000001
        100100000111000000W000001
        1000000000000000000000001
111111111001000001110000000000001
100000000011000001110111111111111
1111011111  11111   11 111
111101111111111111111111111111
111100000000000011100000010001
11110111111111011101010010001
11000000110101011100000000001
10000000000000000000000010001
10000000000000001101010010001
110000011101010111110111100111
11110111 1110101 10111101000101
11111111 1111111 1111111111111
