NO ./path_to_the_north_texture

SO ./path_to_the_south_texture

WE ./path_to_the_west_texture

EA ./path_to_the_east_textur

F 220,250,0

C 225,30,0

        1111111111111
        1000010000111
        1000111000111
        10000W0000011
111111111100000000111
100000000000000000111
110000100000010000001
110000101110010000011
110000100000010000001
110000000011111100001
110000000000000000001
111111111111111111111