NO ./path_to_the_north_texture

SO ./path_to_the_south_texture

WE ./path_to_the_west_texture

EA ./path_to_the_east_textur

F 220,250,0

C 225,30,0


11111111111
    1011101
1111100011011111111111111
1000000000110000000000001       1
1011000001110000000000001      101
100100000000000000000000111111111
111111111011000001110000000000001
100000000011000001110111111111111
11110111111111011100000010001
11110111111111011101010010001
11111111111111111111111111111
11111111111111111111111111111
11000000110101011100000010001
1000000000S00001100000010001
1000000000000000110101001001
1100000111010101111101111000111
11110111 1110101 101111010001
1111111111111111111111111111