NO ./path_to_the_north_texture

SO ./path_to_the_south_texture

WE ./path_to_the_west_texture

EA ./path_to_the_east_textur

F 99,101,44

C 77,23,255

1111111111111111111111111111
1000000000110000011101111111
1111011111111111111111111111
1111011111111111111111111111
1111000000000000111000000101
1111011111111101110101001001
1100000011010101110000000001
1000000000000000000000001001
10000000W0000000110101001001
1100000111010101111101111001
11111111 1111111 11111111111
