NO textures/wall1.png

SO textures/wall2.png

WE textures/wall5.png

EA textures/wall4.png

C 0,0,0

F 0,0,0

 111111111111111  11
100000000001010011001
100010000000010011001
100010000C00010011001
100010C0CNC0010011001
100010000C00010011001
100010C00000010011001
1001000000100C0000001
100000000000010011001
100100010010010000001
1000001000000C00011001
100100000100010010011
 111111111111111 11
