NO textures/wall1.png

SO textures/wall2.png

WE textures/wall5.png

EA textures/wall4.png

C 0,0,0

F 0,0,0

 111111111111111  11
1000000N0001010011001
10001000000C010011001
10001000000C010011001
10001000000C010011001
10001000000C010011001
10001000000C010011001       111111
1001000000100100C0001111111101
100C00000000000011001
1001000100100100C0001
1000001000C00C00011001
100100000100010010011
 111111111111111 11
