NO textures/wall1.png

SO textures/wall2.png

WE textures/wall5.png

EA textures/wall4.png

C 0,0,0

F 0,0,0

 111111111111111  11
100000000001010011001
100010000000010011001
1000101000000C0011001
100010C0N000010011001
100010101C10010011001
100010000000010011001
10010001C110010000001
100000000000000011001
100101C11100010000001
100000000C000C01011001
100100000100010010011
 111111111111111 11
 