NO textures/wall1.png

SO textures/wall2.png

WE textures/wall5.png

EA textures/wall4.png

C 0,0,0

F 0,0,0

 111111111111111  11
100000000001010011001
100010000000010011001
100010000000010011001
100010000000010011001      1111
100010000000010011001     100001
100010000000010011001      110N1
100100000010010000001       1111
100000000000000011001
100100010010010000001
1000001000000000011001
100100000100010010011
 111111111111111 11
