NO  textures/wall1.png

SO textures/wall2.png

WE textures/wall3.png

EA textures/wall4.png

C 0,0,0

F 0,0,0


 111111111111111
10000000000001001
10001000000011001
10010000001000001
100000S0000001001
10010000001000001
10000000000001001
10010000001000001
 111111111111111
