NO ./path_to_the_north_texture.cub

SO      ./path_to_the_south_texture.cub

WE ./path_to_the_west_texture.cub

EA ./path_to_the_east_texture. cub   

F 220,250,0

C 225,30,0


111111111111111111
100000000000000001
100000000010000001
100001000W00010001
1000000000100000101
111111011111111011
11110001011111101
11100101001111101
10000010000000001
1111100011111111
11111111