NO ./path_to_the_north_texture.cub

SO      ./path_to_the_south_texture.cub

WE ./path_to_the_west_texture.cub

EA ./path_to_the_east_texture. cub   

F 220,250,0

C 225,30,0


111111111111111111
100000000000000001
100000000010000001
1000010000W0010001
100000000010000001
111111111111111111