NO ./path_to_the_north_texture.cub

SO      ./path_to_the_south_texture.cub

WE ./path_to_the_west_texture.cub

EA ./path_to_the_east_texture. cub   

F 220,250,0

C 225,30,0


1111111111111111111111111
1000000000000000000001001
10001000000100000000N1001
1001000000100000000001001
1000000000000000000001001
1000000000000000001001001
1000100000010000010001001
1000010000001000000001001
1000000000000000000001001
1111111111111111111111111