NO ./path_to_the_north_texture.cub


SO  ./path_to_the_south_texture.cub 

WE ./path_to_the_west_texture.cub

EA ./path_to_the_east_texture. cub   

F   1,1,1

C 225,30,0


11111111111111111111
1N000000000000001001
10001000000010001001   
10010000001000001001   
10000000000000001001 
11111111111111111111