NO ./path_to_the_north_texture.cub

SO      ./path_to_the_south_texture.cub

WE ./path_to_the_west_texture.cub

EA ./path_to_the_east_texture. cub   

F 220,250,0

C 225,30,0


111111111111111
100000000000001
100000000100001
1000100010N0001
1000000001000101
111110000000011
11100010000001
1111111111111