NO  textures/wall1.png

SO textures/wall2.png

WE textures/wall3.png

EA textures/wall4.png

F 99,101,44

C 77,23,255


 111111111111111
1N000000000001001
10001000000011001
10010000001000001
10000000000001001
10010000001000001
10000000000001001
10010000001000001
 111111111111111
