NO  textures/wall1.png

SO textures/wall2.png

WE textures/wall3.png

EA textures/wall4.png

C 0,0,0

F 0,0,0

 111111111111111
10000000000101001
10001000000D01001
10010000001000001
100D00N0000001001
10010000001000001
1000000000D001001
10010000001000001
 111111111111111
