NO ./textures/wall1.png

SO ./textures/wall2.png

WE ./textures/wall3.png

EA ./textures/wall4.png

F 34,0,54

C 20,100,221

111111111111111111111
1000000000110000011101111111
1111011111111111111111111111
1111011111111111111111111111
1111000000000000111000000101
1111011111D10101110101001001
1100000011D1D101110000000001
1000000000000000000000001001
1000000000S00000110101001001
1100000111010101111101111001
11111111 1111111 11111111111
